###############################
#A     #      #              B#
# ### # # ##### ############ ##
#   # # #   #         #     # #
# ### # ########### # # ### # #
# #   #           # # #     # #
# ######### ##### # # # #######
#   #   #   #   # # # # #   # #
### ### # ### # # ### # # ### #
#   #   #     # #     # #   # #
# ##### ### ### ######### # # #
#       #   #   #     #   # # #
# ##### # # ### ####### # ### #
#   #   # # #       #   #   # #
# # ### # # ##### ### ##### # #
# #   # #   #       #       # #
# ### # ##### ### ##### ##### #
#     # #     #   # #   #     #
# ### ### ##### # # ### ##### #
#   #   #     # # # #   #   # #
##### ##### # # ### # ### # # #
#   #   #   # #     #   #   # #
# # ### ### ### ############# #
# #     #     #     #       # #
# ############## ############ #
#                           # #
###############################
