######################
#A#    #            ##
# # ####### ### ######
#   #     #   #    B##
### ####### ##########
#   #   #   #        #
# ### # ### # ########
#     #   # #        #
# ####### # ##########
#       # #          #
##### ### ######## # #
#         #        # #
# # ######## ####### #
# #       #        # #
# ####### ######## # #
#   #   # #        # #
# # ### # # ######## #
# #     #   #        #
######################
