########################################
#A     #              #             #  #
# # # ##### ### ########### ##### # #  #
#   #           #   #   # # #   # #   ##
##### ### # ######### ### # # ### ### ##
#   #     #   # #   # #     #     #   ##
# # ##### ### # # ### ### ### ####### ##
#   #   #   #   #   #   #   #   #     ##
# # ## ## ### ##### # ##### ### # # # ##
#   #   #   #     # #     #   # # #   ##
##### # ### ##### # ### ### # ### ######
#     #       #   #   # #   #         ##
# ### ##### ### ##### # # ############ #
#     #   #         #   #   #       # ##
# ### ### ##### ### ##### # # ##### # ##
# #   #   #   #   # #     #   #   # # ##
# # ##### # ### ### # ### ##### ### # ##
#   #     #   #   # #   # #   #     # ##
# ########### ##### ### ### ### ##### ##
#   #     #   #   #   #   #     #   # ##
### ##### # ### ### ### ##### # ### # ##
#   #   #   #   #   #   # #   #   # # ##
# ##### # ##### # ##### # # ##### # # ##
#       #       #       #         #   ##
### ######## ################### #######
#       #             #             #  #
# # ##### ##### ##### ### ######### # ##
# #       #       #   #   #   #     # ##
##### ##### ##### ### # ### # ##### # ##
#   #   # #       #   #       #     # ##
# # # # # # # ##### ########### ##### ##
#   #   #         #   #   #   #     # ##
##### ### ### ### ##### ### ##### # # ##
#   #   #   #   #     #   #   #   # # ##
# ### # ### ##### # ##### # ##### # # ##
#   #     #   #   #   # # #   #   #   ##
# ### ### # # ##### ### # ##### ### ####
#   #   # # #   # #   #   #   #     # ##
# # # # ### ### ### ##### ### ##### # ##
# #   #         #   #   #       #     ##
# ##### ##### ##### ### # # ##### # ####
#   #   #     #   #   # #     #   #   ##
### ### # ##### # # ### ######### ### ##
#   #   # #   # #   #     #   #     # ##
# # ##### ### # ### # # ### ### ### # ##
# #       #   #   #   # #   # #   #   ##
##### ##### # ### ##### ### # ##### #  #
#   #   #   #         #   # #     #   ##
# ##### ### ##### ##### # ### ##### ####
#     #       #       #               B#
########################################