#########################################
#A   #    #  #     #   # #    #   #   # #
# ## ### # ### ##### ### # ### ### # # ## 
#        #     #   #     # #       # # ## 
##### ####### ##### ############# ##### #
#   # #     #   # # # #   #   # #   #   #
### # # ### # ### # ### # ### # # # # ###
#     #   # #   #     #     #   # #   # #
# ####### # ### ######### ##### ##### # #
# #     # #     #     # #       #   #   #
# # ### ######### ### # ####### ### ### #
# #   #   #       #   #   #     # #     #
# # ##### ####### # ####### ##### #######
#       # #   #   #     #   #     #   # #
##### ### # # ### ######### ### ### # # #
#   #   #   # # #   #   #   # #     #   #
### ### ##### # ##### ### # ### ### ### #
#   #       #           #   #   #     # #
# ######### ######### # ##### ### ##### #
#       #   #   #   # #       #   #   # #
##### # ### # # # ### ##### ### ### # # #
#   # #   #   #   #   #     # #   #   # #
### ### # ####### ##### # ### # #########
#   #   #     #     #   #   #           #
# # ####### ### # ##### ######### ##### #
# #       #   # #   #   #       #     # #
# # ##### ### # ### # ########### ### # #
# # #   # #   #   #   #         #   #   #
# # # ### ##### ##### # ######### ##### #
#   # #     #   #     #   #   # #       #
##### ##### ##### ####### # # ### ##### #
#   #   #   # #   #     #   # # #     # #
### ### ### # # ### ##### ##### # ##### #
#   #   #     #   #   #   #   #     #   #
# ########### ##### ### ##### ##### #####
#     #   #   #   #   #     #     #   # #
### # # # # # # ##### # ##### ##### # # #
#   #   #   # #     #       #       #   #
################################### #####
#B                                     ##
#########################################
